#####################################################
#                  #                            #   #
#   ### #### ###   # # ### ### ############ ###### ##
#  ##          ##  # # # # # # #            #       #
#  #  #O# #O#   #  # # # # # # # ### ###### #       #
#  #     <      #    # # # # # # #      #   #### ####
#  ##          ##  # # # # # # #     ######   #     #
#   ##### ######   # ### ### ###   ##   # # ##### # #
#                  #               #  # # # #   # # #
#   ### ###  # #################   #  #   # #   # # #
### #       ## #     /  /  /   #  ##  ## ## ### #   #
#   #   ###  #   /  /  /  /  / #  #                 #
# ############ #/  /  /  /  /    ##### ##############
#        #   # #  /     /  /   # #        #         #
######       # # /  /  /  /  / # #   ### ##   ##    #
#      ####### #/  /  /  /  /  # # ###       ####   #
# ## ###       #  /     /  /  /#                    #
#####################################################
