##################
# # # ###  # ### #
# #              #
#    ###### #### #
# #  #         # #
# #  ########### #
# #         #    #
#   ###   ####   #
# ### #####  #   #
#                #
##################
